ANIMATES|Makes a cartoon of
MAN|Homo sapiens
BIRD|Robin or swallow
DUFFEL|Camper's bag
ALP|Swiss peak
LEA|Shepherd's domain
LUNAR|Kind of eclipse
ENOCH|Cain's eldest son
ACTIONDOLL|"G.I. Joe, for one"
NEUMANN|Mathematician John von ___
MATTE|Dull photo finish
ATHENS|Parthenon's home
NEE|Born: Fr.
ACT|Play part
CALLS|Charges on a telephone bill
TWEET|Little bird's sound
UNCLE|___ Remus
LED|Ushered
FATE|Predestination
INESCROW|Held by a third party
IMS|"Private on-line chats, for short"
NAT|"Ah, Wilderness!"" character ___ Miller"
ETO|"War zone, in brief"
SANITARIA|Places for mending
CHEVALIER|Legion of Honor member
RAMEN|Noodle-and-vegetable soup
OREG|33rd state: Abbr.
WINO|Port authority?
TVSPOT|Clio candidate
TRATTORIA|Where to get a Pisa pizza?
VOCAB|Dict. material
STUBS|Some pencils
PATE|Crown
OREM|Utah city
TYRE|It may be kept in a boot
MATAHARI|1932 title role for Greta Garbo
ROTARY|Runaround?
STONEMEN|Masons
ACUTER|More serious
IVEGOTTABEME|1969 Sammy Davis Jr. hit
TOMTOMS|They're beaten hands-down
CRETAN|"El Greco, by birth"
CRAMER|Grammy winner Floyd
REMADE|Like some classic movies
ENERGY|Zip
OTBS|Places to see races: Abbr.
RENAL|___ calculus (kidney stone)
NEMO|Little ___
NANETTE|"Broadway character who sings ""Tea for Two"
ENTER|"Put down, in a way"
OTT|Polo Grounds headliner
OTTERS|Bewhiskered creatures
TETRIS|Popular game from Russia
TRESSY|Like Rapunzel
AMERICANTROTTER|Standardbred
CALCULATE|Work out
ONSALENOW|Common ad phrase
TETRARCHS|Some joint rulers
REY|Foreign leader
CTRS|Municipal sites: Abbr.
ARRIS|Gallico's Mrs. ___
SMUT|Dirt
SKIRT|Bypass
METAL|It may be forged
CLASSY|Elegant
CHUTE|Back pack?
SNAKELEATHER|"Belt material, perhaps"
SLAM|Dis
NORA|"Ibsen's ""doll"
ALAN|"The Way We Were"" writer Bergman"
AHAB|1956 Gregory Peck role
TAUR|Bullish opening
LOLITA|Tease
HAUNCHES|Hindquarters
HAT|Word with dance or band
ERE|It may come before long
SPR|Abbr. in a resort's name
ARARAT|Genesis locale
AUTOHARP|Folk singer's accompaniment
BREWSTER|William aboard the Mayflower
SPARKY|Nickname for 14-Down
STEAD|Place
PIANO|32-Down's was a toy
ATTIC|Place for a chest
RHEO|Stat start
KERNEL|Bit of truth?
YDS|QB's gains
SES|"His, in France"
SHEL|Cartoonist Silverstein
EARLY|At dawn
SWAYERS|"Marathon dancers, e.g."
GAM|School of whales
GOODGRIEF|Comment from Charlie Brown
ARTIE|Musical Shaw
METER|Olympics length
TITHED|Like a portion of some people's income
CHAW|"Plug, of a sort"
CHARLESSCHULZ|This puzzle's honoree
ORE|It may be reached by tunnel
EATERS|Cafeteria-goers
HERA|Hectorer of Zeus
OTT|Giant of old
ANION|Negative particle
SALLY|Charlie's little sister
STEINEM|Ms. magazine co-founder
DIE|Game piece
DOC|Stethoscope user
ENTR|___'acte
NUKE|Microwave
YEAGER|Test pilot Chuck
ARTFUL|Dexterous
BLUELY|In a sad way
BOSUNS|Ship officers
YVONNES|Actress De Carlo and others
RRR|"School basics, in a way"
ITSO|"Wishing Will Make ___"
ISH|Suffix akin to -esque
TAO|Chinese truth
SCHROEDER|Big Beethoven devotee
KIEV|Chicken ___
STIPE|Michael of R.E.M.
PLO|Mideast grp.
ELS|Chicago trains
SACS|Anatomical holders
ENSOR|"Entry of Christ Into Brussels"" artist"
REEL|It might give you a line
FELL|Tumbled
HOHUM|Bor-r-r-r-ring
MATLESS|Like a bare floor
ESNE|Laborer of old
UFOS|Subjects of a U.S. Air Force cover-up?
RNA|Messenger ___
MCNEIL|Actress Claudia
IMSURE|"Yeah, right!"
GHOSTS|Some trick-or-treaters
THEFAVORITE|One that bets are on
ODIST|"Wordsworth, e.g."
REGIS|Denver's ___ University
IAMSO|Response to a disbeliever
MPS|AWOL catchers
REES|Roger of stage and screen
DEAR|Sugar
RELS|Genealogical listings: Abbr.
ROTS|Spoils
ALD|Certain council member: Abbr.
STIGMA|Black mark
SAL|"___ the Stockbroker on ""The Howard Stern Show"
TSE|Literary inits.
OBOE|Kind of reed
TIE|Standoff
ASSISI|Birthplace of St. Clare
TOYS|Chest contents
EAR|Tarsus : foot :: incus : ___
LETSON|Admits
SYS|___ admin
SHARP|Like some cheddar
SHH|"Zip your lip!"
HIALEAH|Historic racetrack site
ARMAGNAC|Eau de vie from Gascony
REMY|"Ratatouille"" rat chef"
PRELL|Green shampoo brand
HUNAN|Spicy Asian cuisine
HOTWAR|"Korean conflict, for one"
USH|"Escort to a seat, slangily"
NOR|Fish-fowl connector
ALOE|Soothing succulent
NEWT|Small salamander
MFA|Musician's deg.
MAALOX|"___ moment"" (ad catchphrase)"
FINITO|Over and done
ATTAIN|Reach
HIRER|"Personnel director, at times"
OSOLE|"___ Mio"
AIT|Small island in a river
HAMMERTHROW|Olympic track-and-field event
ROLF|Massage deeply
ANT|Toiler on a hill
LAYLOW|Knock to the ground
ETALIA|Latin list ender
ARIETTA|Short opera piece
PEG|Simple hanger
PCS|Desk toppers
LLAMA|Beast in an Ogden Nash poem
MODELAS|1903-04 cars sold only in red
ASEC|"Just ___!"
ROTI|"Roasted, in Rouen"
CANI|Childish plea
ICHABOD|Washington Irving's Crane
TIL|"No later than, briefly"
NCOS|Cpls. and sgts.
SHACK|Humble abode
KERI|"Actress Russell of ""Waitress"
DEICE|Make ready for winter flight
CHEESECLOTH|Loosely woven cotton fabric
ENT|"The Lord of the Rings"" creature"
SEEP|Ooze
HOUSEPET|"Collar wearer, often"
ARNEL|Vintage synthetic fabric
STOPS|Parts of a tour
PRESENT|Roll call response
SAX|Clarence Clemons's instrument
RABBITEARS|"Indoor dipole antenna, colloquially"
ROSTER|Team listing
AMPERE|Current measure
BOYTOY|Young stud
RANSOM|Money of exchange
SLOT|___ machine
AURA|Subtle glow
OMOO|Melville work set in Tahiti
MOOED|Made low noises?
SEX|Census datum
SPYDOM|World of espionage
OJOS|Spanish eyes
MASC|Opposite of fem.
NOOSES|Causes of some untimely ends
SOLI|Star turns in music
TET|Lunar New Year in Vietnam
CTR|Basketball position: Abbr.
KEA|Mauna ___
NAY|Roll call response
ERO|Leandro's love
OSTEO|Bone: Prefix
ELENA|Dementieva of tennis
REY|Palacio resident
SCRAM|"Beat it!"
DITTY|"Mary Had a Little Lamb,"" e.g."
CZAR|Industry honcho
CROC|"Swamp menace, for short"
ZERO|Total loser
ALEC|Guinness or Waugh
ROOKS|"Corner pieces, in chess"
MATH|"Do the ___!"
MAXI|Calf-length dress
ADULT|X-rated
TIL|"Up to, in ads"
HOTTIE|Real babe
FEST|Suffix with beer or fun
FOOTPRINT|Evidence washed away by the tide
ENLAI|China's Zhou ___
SCARP|Bluff formed by a fault
EXULT|Jump for joy
LUXOR	|Locale of Theban ruins
JOHNWILKESBOOTH|"Sic semper tyrannis!" crier"
JOGS|"Uses a treadmill, maybe"
PRUNEJUICE|Good source of potassium